41 41
1
#########################################
            #                     #     #
# ####### ### ############# ##### # ### #
# #       #   #   #         #   #   # # #
# # ####### ### # # ########### # ### # #
# # #   # #     # #   #   #     #   #   #
# # ### # ####### ### # # # ####### #####
# # #   #   #     #   # # #   #     #   #
# # # ##### ### ### ##### ### # ##### # #
# #   # #       # # #   # #     # #   # #
# ##### # ####### # ### # ####### # ### #
#   # #   #       # #   # #         #   #
### # # ### ####### # ### # ######### # #
# # #   #   # #     # #   # #         # #
# # # ### ### # ##### # ### # ######### #
#   #     # # #   #   # # # #   #   #   #
### ### ### # ### # ### # # ### # # ### #
# #     #     #         # #   # # #   # #
# ### ####### ### # ##### ### # ### # # #
#     #     #     #     #   # #   # # # #
# ##### ### ########### # # # ### ### # #
#       #   #   #       # #   # #     # #
######### ### # ####### # ##### ####### #
#         #   #       #   #     #   # # #
# ######### ######### # ### ##### # # # #
#         # #     #   #   # #     #   # #
######### # # # ### ##### # # ### # ### #
#       #   # # #   #   # #   #   # #   #
# ########### # # ### # # ##### ##### ###
#         #   #   #   # #     #   #     #
# ######### ######### # ##### ### # ### #
# #       #           #   # #   # # #   #
# # # ### ####### ####### # ### # # # ###
#   #   #         #   #   # #   #   # # #
####### ####### ### # # ### # ####### # #
#   # # #       #   #   #     # #   #   #
# # # # # ####### ######### ### # # ### #
# #   # #   #   #     #   #   #   #   # #
# ### # ### # ####### ### ### # # ### # #
#   #   #   #             #   # #   #    
#########################################
