21 21
1
#####################
          #   #     #
# ####### # # # ### #
#       #   # # #   #
####### ##### # # ###
#       # #   # #   #
# ####### # ### ### #
#       # #     # # #
####### # ####### # #
# #     #           #
# # ############# ###
#   #             # #
##### ############# #
#   # #       #     #
# # # # ##### # #####
# #   #     #   #   #
# ######### ##### # #
#     #     #   # # #
### # # # ##### # # #
#   #   #         #  
#####################
